1111111111111111111111111111111111111
1111111111000000000011111110000001001
1110000000P01110000000110000000110001
111111111100000000C011111110000001001
1110110101000000011110001100100000101
1111111111111111111111111111111111111