1111111111111111111111111
100C0000000110000E1000011
100C000000011000010000011
11000C0000001111100001101
11000C0000001111100001101
1000011100010010000011001
1000011100010010000011001
1000011100010010000011001
1000011100010010000011001
10P0000000110000000001001
1000011100010010000011001
1111111111111111111111111