1111111111111111111111
100C0000000110000E1001
11000C0000001111100001
1000011100010010000011
10P0000000110000000001
1111111111111111111111