1111111111111111111111111111111111111111111111111111111111111111111111111111111111111111111111111111111111111111111
1111111111111111111111111111111111111111111111111111111111111111111111111111111111111111111111111111111111111111111
100C000000010000010000010010010010010010010010010010010010010011111111111111111111111111111111111111111111111111111
100C000P000100000E1000010010010010010010010010010010010010010011111111111111111111111111111111111111111111111111111
11000C0000000011100001101101101101101101101101101101101101101101111111111111111111111111111111111111111111111111111
11000C0000000000000001101101101101101101101101101101101101101101111111111111111111111111111111111111111111111111111
11000C0000000000000001101101101101101101101101101101101101101101111111111111111111111111111111111111111111111111111
11000C0000000000000001101101101101101101101101101101101101101101111111111111111111111111111111111111111111111111111
11000C0000000000000001101101101101101101101101101101101101101101111111111111111111111111111111111111111111111111111
11000C0000000000000001101101101101101101101101101101101101101101111111111111111111111111111111111111111111111111111
11000C0000000000000001101101101101101101101101101101101101101101111111111111111111111111111111111111111111111111111
11000C0000000000000001101101101101101101101101101101101101101101111111111111111111111111111111111111111111111111111
11000C0000000000000001101101101101101101101101101101101101101101111111111111111111111111111111111111111111111111111
11000C0000000000000001101101101101101101101101101101101101101101111111111111111111111111111111111111111111111111111
11000C0000000000000001101101101101101101101101101101101101101101111111111111111111111111111111111111111111111111111
11000C0000000000000001101101101101101101101101101101101101101101111111111111111111111111111111111111111111111111111
11000C000000000000000110110110110110110110110R101101101101101101111111111111111111111111111111111111111111111111111
11000C0000000000000001101101101101101101101101101101101101101101111111111111111111111111111111111111111111111111111
1111111111111111111111111111111111111111111111111111111111111111111111111111111111111111111111111111111111111111111