111111111111111111111111111111111111111111111111111111111111111111111111111111111111111111111111111111111111111111111111111111111111111111111111111111111111111111111111111111111111111111111111111111111111111111111111111111111111
1E0000000000000C000000000000000000C000000000000000000C000000000000000000C000000000000000000C000000000000000000C000000000000000000C000000000000000000C000000000000000000C000000000000000000C000000000000000000C000000000000000000C001
101001010010000010100100101001000001010010010100100000101001001010010000010100100101001000001010010010100100000101001001010010000010100100101001000001010010010100100000101001001010010000010100100101001000001010010010100100000101
101001001010101000100100100101010100010010010010101010001001001001010101000100100100101010100010010010010101010001001001001010101000100100100101010100010010010010101010001001001001010101000100100100101010100010010010010101010001
1P0000000C00C000000000000000C00C000000000000000C00C000000000000000C00C000000000000000C00C000000000000000C00C000000000000000C00C000000000000000C00C000000000000000C00C000000000000000C00C000000000000000C00C000000000000000C00C000001
111111111111111111111111111111111111111111111111111111111111111111111111111111111111111111111111111111111111111111111111111111111111111111111111111111111111111111111111111111111111111111111111111111111111111111111111111111111111