11111111111
111100011C1
111100011C1
111100011C1
111100011C1
111100011C1
111100011C1
1111E0011C1
111100011C1
111100011C1
111100011C1
111100011C1
111100011C1
1111P0000C1
11111111111