11111111111
100011000C1
111100011C1
111100011C1
111100011C1
111100011C1
111100011C1
111100011C1
111100011C1
111100011C1
111100011C1
111100011C1
111100011C1
111100011C1
111100011C1
111100011C1
111100011C1
111100011C1
111100011C1
111100011C1
111100011C1
111100011C1
111100011C1
111100011C1
111100011C1
111100011C1
111100011C1
111100011C1
111100011C1
111100011C1
111100011C1
111100011C1
111100011C1
111100011C1
111100011C1
111100011C1
111100011C1
111100011C1
111100011C1
111100011C1
111100011C1
111100011C1
111100011C1
111100011C1
111100011C1
111100011C1
111100011C1
111100011C1
111100011C1
111100011C1
111100011C1
111100011C1
111100011C1
111100011C1
111100011C1
111100011C1
111100011C1
111100011C1
111100011C1
111100011C1
111100011C1
111100011C1
111100011C1
111100011C1
111100011C1
111100011C1
111100011C1
111100011C1
111100011C1
111100011C1
111100011C1
111100011C1
111100011C1
111100011C1
111100011C1
111100011C1
111100011C1
111100011C1
111100011C1
111100011C1
111100011C1
111100011C1
111100011C1
111100011C1
111100011C1
111100011C1
111100011C1
111100011C1
111100011C1
111100011C1
111100011C1
111100011C1
111100011C1
111100011C1
111100011C1
111100011C1
111100011C1
111100011C1
111100011C1
111100011C1
111100011C1
111100011C1
111100011C1
111100011C1
111100011C1
111100011C1
111100011C1
111100011C1
111100011C1
111100011C1
111100011C1
111100011C1
111100011C1
111100011C1
111100011C1
111100011C1
111100011C1
111100011C1
111100011C1
111100011C1
111100011C1
111100011C1
111100011C1
111100011C1
111100011C1
111100011C1
111100011C1
111100011C1
111100011C1
111100011C1
111100011C1
111100011C1
111100011C1
111100011C1
111100011C1
111100011C1
111100011C1
111100011C1
111100011C1
111100011C1
111100011C1
111100011C1
111100011C1
111100011C1
111100011C1
111100011C1
111100011C1
111100011C1
111100011C1
111100011C1
111100011C1
111100011C1
111100011C1
111100011C1
111100011C1
111100011C1
111100011C1
111100011C1
111100011C1
111100011C1
111100011C1
111100011C1
111100011C1
111100011C1
111100011C1
111100011C1
111100011C1
111100011C1
111100011C1
111100011C1
111100011C1
111100011C1
111100011C1
111100011C1
111100011C1
111100011C1
111100011C1
111100011C1
111100011C1
111100011C1
111100011C1
111100011C1
111100011C1
111100011C1
111100011C1
111100011C1
111100011C1
111100011C1
111100011C1
111100011C1
111100011C1
111100011C1
111100011C1
111100011C1
111100011C1
111100011C1
111100011C1
111100011C1
111100011C1
111100011C1
111100011C1
111100011C1
111100011C1
111100011C1
111100011C1
111100011C1
111100011C1
111100011C1
111100011C1
111100011C1
111100011C1
111100011C1
111100011C1
111100011C1
111100011C1
111100011C1
111100011C1
111100011C1
111100011C1
111100011C1
111100011C1
111100011C1
111100011C1
111100011C1
111100011C1
111100011C1
111100011C1
111100011C1
111100011C1
111100011C1
111100011C1
111100011C1
111100011C1
111100011C1
111100011C1
111100011C1
111100011C1
111100011C1
111100011C1
111100011C1
111100011C1
111100011C1
111100011C1
111100011C1
111100011C1
111100011C1
111100011C1
111100011C1
111100011C1
111100011C1
111100011C1
111100011C1
111100011C1
111100011C1
111100011C1
111100011C1