11111111111111111111111111111111111111111111111111111111111111111111111111111111111111111111111111111111111111111111111111111111111111111111111111111111111111111111111111111111111111111111111111111111111111111111111111111111111111
10CC00CC00CC00CC00CC00CC00CC00CC00CC00CC00CC00CC00CC00CC00CC00CC00CC00CC00CC00CC00CC00CC00CC00CC00CC00CC00CC00CC00CC00CC00CC00CC00CC00CC00CC00CC00CC00CC00CC00CC00CC00CC00CC00CC00CC00CC00CC00CC00CC00CC00CC00CC00CC00CC00CC00CC00CC01
11101110111011101110111011101110111011101110111011101110111011101110111011101110111011101110111011101110111011101110111011101110111011101110111011101110111011101110111011101110111011101110111011101110111011101110111011101110111011
10000000000000000000000000000000000000000000000000000000000000000000000000000000000000000000000000000000000000000000000000000000000000000000000000000000000000000000000000000000000000000000000000000000000000000000000000000000000001
10000001000100010001000100010001000100010001000100010001000100010001000100010001000100010001000100010001000100010001000100010001000100010001000100010001000100010001000100010001000100010001000100010001000100010001000100010001000101
10CC00CC00CC00CC00CC00CC00CC00CC00CC00CC00CC00CC00CC00CC00CC00CC00CC00CC00CC00CC00CC00CC00CC00CC00CC00CC00CC00CC00CC00CC00CC00CC00CC00CC00CC00CC00CC00CC00CC00CC00CC00CC00CC00CC00CC00CC00CC00CC00CC00CC00CC00CC00CC00CC00CC00CC00CC01
11101110111011101110111011101110111011101110111011101110111011101110111011101110111011101110111011101110111011101110111011101110111011101110111011101110111011101110111011101110111011101110111011101110111011101110111011101110111011
10000000000000000000000000000000000000000000000000000000000000000000000000000000000000000000000000000000000000000000000000000000000000000000000000000000000000000000000000000000000000000000000000000000000000000000000000000000000001
10000001000100010001000100010001000100010001000100010001000100010001000100010001000100010001000100010001000100010001000100010001000100010001000100010001000100010001000100010001000100010001000100010001000100010001000100010001000101
10CC00CC00CC00CC00CC00CC00CC00CC00CC00CC00CC00CC00CC00CC00CC00CC00CC00CC00CC00CC00CC00CC00CC00CC00CC00CC00CC00CC00CC00CC00CC00CC00CC00CC00CC00CC00CC00CC00CC00CC00CC00CC00CC00CC00CC00CC00CC00CC00CC00CC00CC00CC00CC00CC00CC00CC00CC01
11101110111011101110111011101110111011101110111011101110111011101110111011101110111011101110111011101110111011101110111011101110111011101110111011101110111011101110111011101110111011101110111011101110111011101110111011101110111011
10000000000000000000000000000000000000000000000000000000000000000000000000000000000000000000000000000000000000000000000000000000000000000000000000000000000000000000000000000000000000000000000000000000000000000000000000000000000001
10000001000100010001000100010001000100010001000100010001000100010001000100010001000100010001000100010001000100010001000100010001000100010001000100010001000100010001000100010001000100010001000100010001000100010001000100010001000101
10CC00CC00CC00CC00CC00CC00CC00CC00CC00CC00CC00CC00CC00CC00CC00CC00CC00CC00CC00CC00CC00CC00CC00CC00CC00CC00CC00CC00CC00CC00CC00CC00CC00CC00CC00CC00CC00CC00CC00CC00CC00CC00CC00CC00CC00CC00CC00CC00CC00CC00CC00CC00CC00CC00CC00CC00CC01
11101110111011101110111011101110111011101110111011101110111011101110111011101110111011101110111011101110111011101110111011101110111011101110111011101110111011101110111011101110111011101110111011101110111011101110111011101110111011
10000000000000000000000000000000000000000000000000000000000000000000000000000000000000000000000000000000000000000000000000000000000000000000000000000000000000000000000000000000000000000000000000000000000000000000000000000000000001
10000001000100010001000100010001000100010001000100010001000100010001000100010001000100010001000100010001000100010001000100010001000100010001000100010001000100010001000100010001000100010001000100010001000100010001000100010001000101
10CC00CC00CC00CC00CC00CC00CC00CC00CC00CC00CC00CC00CC00CC00CC00CC00CC00CC00CC00CC00CC00CC00CC00CC00CC00CC00CC00CC00CC00CC00CC00CC00CC00CC00CC00CC00CC00CC00CC00CC00CC00CC00CC00CC00CC00CC00CC00CC00CC00CC00CC00CC00CC00CC00CC00CC00CC01
11101110111011101110111011101110111011101110111011101110111011101110111011101110111011101110111011101110111011101110111011101110111011101110111011101110111011101110111011101110111011101110111011101110111011101110111011101110111011
10000000000000000000000000000000000000000000000000000000000000000000000000000000000000000000000000000000000000000000000000000000000000000000000000000000000000000000000000000000000000000000000000000000000000000000000000000000000001
10000001000100010001000100010001000100010001000100010001000100010001000100010001000100010001000100010001000100010001000100010001000100010001000100010001000100010001000100010001000100010001000100010001000100010001000100010001000101
10CC00CC00CC00CC00CC00CC00CC00CC00CC00CC00CC00CC00CC00CC00CC00CC00CC00CC00CC00CC00CC00CC00CC00CC00CC00CC00CC00CC00CC00CC00CC00CC00CC00CC00CC00CC00CC00CC00CC00CC00CC00CC00CC00CC00CC00CC00CC00CC00CC00CC00CC00CC00CC00CC00CC00CC00CC01
11101110111011101110111011101110111011101110111011101110111011101110111011101110111011101110111011101110111011101110111011101110111011101110111011101110111011101110111011101110111011101110111011101110111011101110111011101110111011
10000000000000000000000000000000000000000000000000000000000000000000000000000000000000000000000000000000000000000000000000000000000000000000000000000000000000000000000000000000000000000000000000000000000000000000000000000000000001
10000001000100010001000100010001000100010001000100010001000100010001000100010001000100010001000100010001000100010001000100010001000100010001000100010001000100010001000100010001000100010001000100010001000100010001000100010001000101
10CC00CC00CC00CC00CC00CC00CC00CC00CC00CC00CC00CC00CC00CC00CC00CC00CC00CC00CC00CC00CC00CC00CC00CC00CC00CC00CC00CC00CC00CC00CC00CC00CC00CC00CC00CC00CC00CC00CC00CC00CC00CC00CC00CC00CC00CC00CC00CC00CC00CC00CC00CC00CC00CC00CC00CC00CC01
11101110111011101110111011101110111011101110111011101110111011101110111011101110111011101110111011101110111011101110111011101110111011101110111011101110111011101110111011101110111011101110111011101110111011101110111011101110111011
10000000000000000000000000000000000000000000000000000000000000000000000000000000000000000000000000000000000000000000000000000000000000000000000000000000000000000000000000000000000000000000000000000000000000000000000000000000000001
10000001000100010001000100010001000100010001000100010001000100010001000100010001000100010001000100010001000100010001000100010001000100010001000100010001000100010001000100010001000100010001000100010001000100010001000100010001000101
10CC00CC00CC00CC00CC00CC00CC00CC00CC00CC00CC00CC00CC00CC00CC00CC00CC00CC00CC00CC00CC00CC00CC00CC00CC00CC00CC00CC00CC00CC00CC00CC00CC00CC00CC00CC00CC00CC00CC00CC00CC00CC00CC00CC00CC00CC00CC00CC00CC00CC00CC00CC00CC00CC00CC00CC00CC01
11101110111011101110111011101110111011101110111011101110111011101110111011101110111011101110111011101110111011101110111011101110111011101110111011101110111011101110111011101110111011101110111011101110111011101110111011101110111011
10000000000000000000000000000000000000000000000000000000000000000000000000000000000000000000000000000000000000000000000000000000000000000000000000000000000000000000000000000000000000000000000000000000000000000000000000000000000001
10000001000100010001000100010001000100010001000100010001000100010001000100010001000100010001000100010001000100010001000100010001000100010001000100010001000100010001000100010001000100010001000100010001000100010001000100010001000101
10CC00CC00CC00CC00CC00CC00CC00CC00CC00CC00CC00CC00CC00CC00CC00CC00CC00CC00CC00CC00CC00CC00CC00CC00CC00CC00CC00CC00CC00CC00CC00CC00CC00CC00CC00CC00CC00CC00CC00CC00CC00CC00CC00CC00CC00CC00CC00CC00CC00CC00CC00CC00CC00CC00CC00CC00CC01
11101110111011101110111011101110111011101110111011101110111011101110111011101110111011101110111011101110111011101110111011101110111011101110111011101110111011101110111011101110111011101110111011101110111011101110111011101110111011
10000000000000000000000000000000000000000000000000000000000000000000000000000000000000000000000000000000000000000000000000000000000000000000000000000000000000000000000000000000000000000000000000000000000000000000000000000000000001
10000001000100010001000100010001000100010001000100010001000100010001000100010001000100010001000100010001000100010001000100010001000100010001000100010001000100010001000100010001000100010001000100010001000100010001000100010001000101
10CC00CC00CC00CC00CC00CC00CC00CC00CC00CC00CC00CC00CC00CC00CC00CC00CC00CC00CC00CC00CC00CC00CC00CC00CC00CC00CC00CC00CC00CC00CC00CC00CC00CC00CC00CC00CC00CC00CC00CC00CC00CC00CC00CC00CC00CC00CC00CC00CC00CC00CC00CC00CC00CC00CC00CC00CC01
11101110111011101110111011101110111011101110111011101110111011101110111011101110111011101110111011101110111011101110111011101110111011101110111011101110111011101110111011101110111011101110111011101110111011101110111011101110111011
10000000000000000000000000000000000000000000000000000000000000000000000000000000000000000000000000000000000000000000000000000000000000000000000000000000000000000000000000000000000000000000000000000000000000000000000000000000000001
10000001000100010001000100010001000100010001000100010001000100010001000100010001000100010001000100010001000100010001000100010001000100010001000100010001000100010001000100010001000100010001000100010001000100010001000100010001000101
10CC00CC00CC00CC00CC00CC00CC00CC00CC00CC00CC00CC00CC00CC00CC00CC00CC00CC00CC00CC00CC00CC00CC00CC00CC00CC00CC00CC00CC00CC00CC00CC00CC00CC00CC00CC00CC00CC00CC00CC00CC00CC00CC00CC00CC00CC00CC00CC00CC00CC00CC00CC00CC00CC00CC00CC00CC01
11101110111011101110111011101110111011101110111011101110111011101110111011101110111011101110111011101110111011101110111011101110111011101110111011101110111011101110111011101110111011101110111011101110111011101110111011101110111011
10000000000000000000000000000000000000000000000000000000000000000000000000000000000000000000000000000000000000000000000000000000000000000000000000000000000000000000000000000000000000000000000000000000000000000000000000000000000001
10000001000100010001000100010001000100010001000100010001000100010001000100010001000100010001000100010001000100010001000100010001000100010001000100010001000100010001000100010001000100010001000100010001000100010001000100010001000101
10CC00CC00CC00CC00CC00CC00CC00CC00CC00CC00CC00CC00CC00CC00CC00CC00CC00CC00CC00CC00CC00CC00CC00CC00CC00CC00CC00CC00CC00CC00CC00CC00CC00CC00CC00CC00CC00CC00CC00CC00CC00CC00CC00CC00CC00CC00CC00CC00CC00CC00CC00CC00CC00CC00CC00CC00CC01
11101110111011101110111011101110111011101110111011101110111011101110111011101110111011101110111011101110111011101110111011101110111011101110111011101110111011101110111011101110111011101110111011101110111011101110111011101110111011
10000000000000000000000000000000000000000000000000000000000000000000000000000000000000000000000000000000000000000000000000000000000000000000000000000000000000000000000000000000000000000000000000000000000000000000000000000000000001
10000001000100010001000100010001000100010001000100010001000100010001000100010001000100010001000100010001000100010001000100010001000100010001000100010001000100010001000100010001000100010001000100010001000100010001000100010001000101
10CC00CC00CC00CC00CC00CC00CC00CC00CC00CC00CC00CC00CC00CC00CC00CC00CC00CC00CC00CC00CC00CC00CC00CC00CC00CC00CC00CC00CC00CC00CC00CC00CC00CC00CC00CC00CC00CC00CC00CC00CC00CC00CC00CC00CC00CC00CC00CC00CC00CC00CC00CC00CC00CC00CC00CC00CC01
11101110111011101110111011101110111011101110111011101110111011101110111011101110111011101110111011101110111011101110111011101110111011101110111011101110111011101110111011101110111011101110111011101110111011101110111011101110111011
10000000000000000000000000000000000000000000000000000000000000000000000000000000000000000000000000000000000000000000000000000000000000000000000000000000000000000000000000000000000000000000000000000000000000000000000000000000000001
10000001000100010001000100010001000100010001000100010001000100010001000100010001000100010001000100010001000100010001000100010001000100010001000100010001000100010001000100010001000100010001000100010001000100010001000100010001000101
10CC00CC00CC00CC00CC00CC00CC00CC00CC00CC00CC00CC00CC00CC00CC00CC00CC00CC00CC00CC00CC00CC00CC00CC00CC00CC00CC00CC00CC00CC00CC00CC00CC00CC00CC00CC00CC00CC00CC00CC00CC00CC00CC00CC00CC00CC00CC00CC00CC00CC00CC00CC00CC00CC00CC00CC00CC01
11101110111011101110111011101110111011101110111011101110111011101110111011101110111011101110111011101110111011101110111011101110111011101110111011101110111011101110111011101110111011101110111011101110111011101110111011101110111011
10000000000000000000000000000000000000000000000000000000000000000000000000000000000000000000000000000000000000000000000000000000000000000000000000000000000000000000000000000000000000000000000000000000000000000000000000000000000001
10000001000100010001000100010001000100010001000100010001000100010001000100010001000100010001000100010001000100010001000100010001000100010001000100010001000100010001000100010001000100010001000100010001000100010001000100010001000101
10CC00CC00CC00CC00CC00CC00CC00CC00CC00CC00CC00CC00CC00CC00CC00CC00CC00CC00CC00CC00CC00CC00CC00CC00CC00CC00CC00CC00CC00CC00CC00CC00CC00CC00CC00CC00CC00CC00CC00CC00CC00CC00CC00CC00CC00CC00CC00CC00CC00CC00CC00CC00CC00CC00CC00CC00CC01
11101110111011101110111011101110111011101110111011101110111011101110111011101110111011101110111011101110111011101110111011101110111011101110111011101110111011101110111011101110111011101110111011101110111011101110111011101110111011
10000000000000000000000000000000000000000000000000000000000000000000000000000000000000000000000000000000000000000000000000000000000000000000000000000000000000000000000000000000000000000000000000000000000000000000000000000000000001
10000001000100010001000100010001000100010001000100010001000100010001000100010001000100010001000100010001000100010001000100010001000100010001000100010001000100010001000100010001000100010001000100010001000100010001000100010001000101
10CC00CC00CC00CC00CC00CC00CC00CC00CC00CC00CC00CC00CC00CC00CC00CC00CC00CC00CC00CC00CC00CC00CC00CC00CC00CC00CC00CC00CC00CC00CC00CC00CC00CC00CC00CC00CC00CC00CC00CC00CC00CC00CC00CC00CC00CC00CC00CC00CC00CC00CC00CC00CC00CC00CC00CC00CC01
11101110111011101110111011101110111011101110111011101110111011101110111011101110111011101110111011101110111011101110111011101110111011101110111011101110111011101110111011101110111011101110111011101110111011101110111011101110111011
10000000000000000000000000000000000000000000000000000000000000000000000000000000000000000000000000000000000000000000000000000000000000000000000000000000000000000000000000000000000000000000000000000000000000000000000000000000000001
10000001000100010001000100010001000100010001000100010001000100010001000100010001000100010001000100010001000100010001000100010001000100010001000100010001000100010001000100010001000100010001000100010001000100010001000100010001000101
10CC00CC00CC00CC00CC00CC00CC00CC00CC00CC00CC00CC00CC00CC00CC00CC00CC00CC00CC00CC00CC00CC00CC00CC00CC00CC00CC00CC00CC00CC00CC00CC00CC00CC00CC00CC00CC00CC00CC00CC00CC00CC00CC00CC00CC00CC00CC00CC00CC00CC00CC00CC00CC00CC00CC00CC00CC01
11101110111011101110111011101110111011101110111011101110111011101110111011101110111011101110111011101110111011101110111011101110111011101110111011101110111011101110111011101110111011101110111011101110111011101110111011101110111011
10000000000000000000000000000000000000000000000000000000000000000000000000000000000000000000000000000000000000000000000000000000000000000000000000000000000000000000000000000000000000000000000000000000000000000000000000000000000001
10000001000100010001000100010001000100010001000100010001000100010001000100010001000100010001000100010001000100010001000100010001000100010001000100010001000100010001000100010001000100010001000100010001000100010001000100010001000101
10CC00CC00CC00CC00CC00CC00CC00CC00CC00CC00CC00CC00CC00CC00CC00CC00CC00CC00CC00CC00CC00CC00CC00CC00CC00CC00CC00CC00CC00CC00CC00CC00CC00CC00CC00CC00CC00CC00CC00CC00CC00CC00CC00CC00CC00CC00CC00CC00CC00CC00CC00CC00CC00CC00CC00CC00CC01
11101110111011101110111011101110111011101110111011101110111011101110111011101110111011101110111011101110111011101110111011101110111011101110111011101110111011101110111011101110111011101110111011101110111011101110111011101110111011
10000000000000000000000000000000000000000000000000000000000000000000000000000000000000000000000000000000000000000000000000000000000000000000000000000000000000000000000000000000000000000000000000000000000000000000000000000000000001
10000001000100010001000100010001000100010001000100010001000100010001000100010001000100010001000100010001000100010001000100010001000100010001000100010001000100010001000100010001000100010001000100010001000100010001000100010001000101
10CC00CC00CC00CC00CC00CC00CC00CC00CC00CC00CC00CC00CC00CC00CC00CC00CC00CC00CC00CC00CC00CC00CC00CC00CC00CC00CC00CC00CC00CC00CC00CC00CC00CC00CC00CC00CC00CC00CC00CC00CC00CC00CC00CC00CC00CC00CC00CC00CC00CC00CC00CC00CC00CC00CC00CC00CC01
11101110111011101110111011101110111011101110111011101110111011101110111011101110111011101110111011101110111011101110111011101110111011101110111011101110111011101110111011101110111011101110111011101110111011101110111011101110111011
10000000000000000000000000000000000000000000000000000000000000000000000000000000000000000000000000000000000000000000000000000000000000000000000000000000000000000000000000000000000000000000000000000000000000000000000000000000000001
10000001000100010001000100010001000100010001000100010001000100010001000100010001000100010001000100010001000100010001000100010001000100010001000100010001000100010001000100010001000100010001000100010001000100010001000100010001000101
10CC00CC00CC00CC00CC00CC00CC00CC00CC00CC00CC00CC00CC00CC00CC00CC00CC00CC00CC00CC00CC00CC00CC00CC00CC00CC00CC00CC00CC00CC00CC00CC00CC00CC00CC00CC00CC00CC00CC00CC00CC00CC00CC00CC00CC00CC00CC00CC00CC00CC00CC00CC00CC00CC00CC00CC00CC01
11101110111011101110111011101110111011101110111011101110111011101110111011101110111011101110111011101110111011101110111011101110111011101110111011101110111011101110111011101110111011101110111011101110111011101110111011101110111011
10000000000000000000000000000000000000000000000000000000000000000000000000000000000000000000000000000000000000000000000000000000000000000000000000000000000000000000000000000000000000000000000000000000000000000000000000000000000001
10000001000100010001000100010001000100010001000100010001000100010001000100010001000100010001000100010001000100010001000100010001000100010001000100010001000100010001000100010001000100010001000100010001000100010001000100010001000101
10CC00CC00CC00CC00CC00CC00CC00CC00CC00CC00CC00CC00CC00CC00CC00CC00CC00CC00CC00CC00CC00CC00CC00CC00CC00CC00CC00CC00CC00CC00CC00CC00CC00CC00CC00CC00CC00CC00CC00CC00CC00CC00CC00CC00CC00CC00CC00CC00CC00CC00CC00CC00CC00CC00CC00CC00CC01
11101110111011101110111011101110111011101110111011101110111011101110111011101110111011101110111011101110111011101110111011101110111011101110111011101110111011101110111011101110111011101110111011101110111011101110111011101110111011
1000E000000000000000000000000000000000000000000000000000000000000000000000000000000000000000000000000000000000000000000000000000000000000000000000000000000000000000000000000000000000000000000000000000000000000000000000000000000001
10000001000100010001000100010001000100010001000100010001000100010001000100010001000100010001000100010001000100010001000100010001000100010001000100010001000100010001000100010001000100010001000100010001000100010001000100010001000101
10CC00CC00CC00CC00CC00CC00CC00CC00CC00CC00CC00CC00CC00CC00CC00CC00CC00CC00CC00CC00CC00CC00CC00CC00CC00CC00CC00CC00CC00CC00CC00CC00CC00CC00CC00CC00CC00CC00CC00CC00CC00CC00CC00CC00CC00CC00CC00CC00CC00CC00CC00CC00CC00CC00CC00CC00CC01
11101110111011101110111011101110111011101110111011101110111011101110111011101110111011101110111011101110111011101110111011101110111011101110111011101110111011101110111011101110111011101110111011101110111011101110111011101110111011
10000000000000000000000000000000000000000000000000000000000000000000000000000000000000000000000000000000000000000000000000000000000000000000000000000000000000000000000000000000000000000000000000000000000000000000000000000000000001
10000001000100010001000100010001000100010001000100010001000100010001000100010001000100010001000100010001000100010001000100010001000100010001000100010001000100010001000100010001000100010001000100010001000100010001000100010001000101
10CC00CC00CC00CC00CC00CC00CC00CC00CC00CC00CC00CC00CC00CC00CC00CC00CC00CC00CC00CC00CC00CC00CC00CC00CC00CC00CC00CC00CC00CC00CC00CC00CC00CC00CC00CC00CC00CC00CC00CC00CC00CC00CC00CC00CC00CC00CC00CC00CC00CC00CC00CC00CC00CC00CC00CC00CC01
11101110111011101110111011101110111011101110111011101110111011101110111011101110111011101110111011101110111011101110111011101110111011101110111011101110111011101110111011101110111011101110111011101110111011101110111011101110111011
100P0000000000000000000000000000000000000000000000000000000000000000000000000000000000000000000000000000000000000000000000000000000000000000000000000000000000000000000000000000000000000000000000000000000000000000000000000000000001
10000001000100010001000100010001000100010001000100010001000100010001000100010001000100010001000100010001000100010001000100010001000100010001000100010001000100010001000100010001000100010001000100010001000100010001000100010001000101
10CC00CC00CC00CC00CC00CC00CC00CC00CC00CC00CC00CC00CC00CC00CC00CC00CC00CC00CC00CC00CC00CC00CC00CC00CC00CC00CC00CC00CC00CC00CC00CC00CC00CC00CC00CC00CC00CC00CC00CC00CC00CC00CC00CC00CC00CC00CC00CC00CC00CC00CC00CC00CC00CC00CC00CC00CC01
11101110111011101110111011101110111011101110111011101110111011101110111011101110111011101110111011101110111011101110111011101110111011101110111011101110111011101110111011101110111011101110111011101110111011101110111011101110111011
10000000000000000000000000000000000000000000000000000000000000000000000000000000000000000000000000000000000000000000000000000000000000000000000000000000000000000000000000000000000000000000000000000000000000000000000000000000000001
10000001000100010001000100010001000100010001000100010001000100010001000100010001000100010001000100010001000100010001000100010001000100010001000100010001000100010001000100010001000100010001000100010001000100010001000100010001000101
10CC00CC00CC00CC00CC00CC00CC00CC00CC00CC00CC00CC00CC00CC00CC00CC00CC00CC00CC00CC00CC00CC00CC00CC00CC00CC00CC00CC00CC00CC00CC00CC00CC00CC00CC00CC00CC00CC00CC00CC00CC00CC00CC00CC00CC00CC00CC00CC00CC00CC00CC00CC00CC00CC00CC00CC00CC01
11101110111011101110111011101110111011101110111011101110111011101110111011101110111011101110111011101110111011101110111011101110111011101110111011101110111011101110111011101110111011101110111011101110111011101110111011101110111011
11111111111111111111111111111111111111111111111111111111111111111111111111111111111111111111111111111111111111111111111111111111111111111111111111111111111111111111111111111111111111111111111111111111111111111111111111111111111111