1111111111111111111111111111111111
10CC00CC00CC00CC00CC00CC00CC00CC01
1110111011101110111011101110111011
1000000000000000000000000000000001
1000000100010001000100010001000101
10CC00CC00CC00CC00CC00CC00CC00CC01
1110111011101110111011101110111011
1000000000000000000000000000000001
1000000100010001000100010001000101
10CC00CC00CC00CC00CC00CC00CC00CC01
1110111011101110111011101110111011
1000000000000000000000000000000001
1000000100010001000100010001000101
10CC00CC00CC00CC00CC00CC00CC00CC01
1110111011101110111011101110111011
1000000000000000000000000000000001
1000000100010001000100010001000101
10CC00CC00CC00CC00CC00CC00CC00CC01
1110111011101110111011101110111011
1000000000000000000000000000000001
1000000100010001000100010001000101
10CC00CC00CC00CC00CC00CC00CC00CC01
1110111011101110111011101110111011
1000000000000000000000000000000001
1000000100010001000100010001000101
10CC00CC00CC00CC00CC00CC00CC00CC01
1110111011101110111011101110111011
1000000000000000000000000000000001
1000000100010001000100010001000101
10CC00CC00CC00CC00CC00CC00CC00CC01
1110111011101110111011101110111011
1000000000000000000000000000000001
1000000100010001000100010001000101
10CC00CC00CC00CC00CC00CC00CC00CC01
1110111011101110111011101110111011
1000000000000000000000000000000001
1000000100010001000100010001000101
10CC00CC00CC00CC00CC00CC00CC00CC01
1110111011101110111011101110111011
1000000000000000000000000000000001
1000000100010001000100010001000101
10CC00CC00CC00CC00CC00CC00CC00CC01
1110111011101110111011101110111011
1000000000000000000000000000000001
1000000100010001000100010001000101
10CC00CC00CC00CC00CC00CC00CC00CC01
1110111011101110111011101110111011
1000000000000000000000000000000001
1000000100010001000100010001000101
10CC00CC00CC00CC00CC00CC00CC00CC01
1110111011101110111011101110111011
1000000000000000000000000000000001
1000000100010001000100010001000101
10CC00CC00CC00CC00CC00CC00CC00CC01
1110111011101110111011101110111011
1000000000000000000000000000000001
1000000100010001000100010001000101
10CC00CC00CC00CC00CC00CC00CC00CC01
1110111011101110111011101110111011
1000000000000000000000000000000001
1000000100010001000100010001000101
10CC00CC00CC00CC00CC00CC00CC00CC01
1110111011101110111011101110111011
1000000000000000000000000000000001
1000000100010001000100010001000101
10CC00CC00CC00CC00CC00CC00CC00CC01
1110111011101110111011101110111011
1000000000000000000000000000000001
1000000100010001000100010001000101
10CC00CC00CC00CC00CC00CC00CC00CC01
1110111011101110111011101110111011
1000000000000000000000000000000001
1000000100010001000100010001000101
10CC00CC00CC00CC00CC00CC00CC00CC01
1110111011101110111011101110111011
1000000000000000000000000000000001
1000000100010001000100010001000101
10CC00CC00CC00CC00CC00CC00CC00CC01
1110111011101110111011101110111011
1000000000000000000000000000000001
1000000100010001000100010001000101
10CC00CC00CC00CC00CC00CC00CC00CC01
1110111011101110111011101110111011
1000000000000000000000000000E00001
1000000100010001000100010001000101
10CC00CC00CC00CC00CC00CC00CC00CC01
1110111011101110111011101110111011
1000000000000000000000000000000001
1000000100010001000100010001000101
10CC00CC00CC00CC00CC00CC00CC00CC01
1110111011101110111011101110111011
100000000000P000000000000000000001
1000000100010001000100010001000101
10CC00CC00CC00CC00CC00CC00CC00CC01
1110111011101110111011101110111011
1000000000000000000000000000000001
1000000100010001000100010001000101
10CC00CC00CC00CC00CC00CC00CC00CC01
1110111011101110111011101110111011
1111111111111111111111111111111111