1111111111111111111111111111111111
10CC00CC00CC00CC00CC00CC00CC00CC01
1110111011101110111011101110111011
1000P00000000000000000000000000001
100E000100010001000100010001000101
1111111111111111111111111111111111
